0133:      { 000 5 ---  010 5 ---  001 5 ---  011 5 --- }
0134:      { 002 5 ---  012 5 ---  003 5 ---  013 5 --- }
0135:      { 020 5 ---  020 5 ---  021 5 ---  021 5 --- }
0136:      { 022 5 ---  022 5 ---  023 5 ---  023 5 --- }
0137:      { 000 5 ---  010 5 ---  001 5 ---  011 5 --- }
0138:      { 002 5 ---  012 5 ---  003 5 ---  013 5 --- }
0139:      { 000 5 ---  010 5 ---  001 5 ---  011 5 --- }
013A:      { 002 5 ---  012 5 ---  003 5 ---  013 5 --- }
