0133:      { 000 3 ---  010 3 ---  001 3 ---  011 3 --- }
0134:      { 002 3 ---  012 3 ---  003 3 ---  013 3 --- }
0135:      { 020 3 ---  020 3 ---  021 3 ---  021 3 --- }
0136:      { 022 3 ---  022 3 ---  023 3 ---  023 3 --- }
0137:      { 000 3 ---  010 3 ---  001 3 ---  011 3 --- }
0138:      { 002 3 ---  012 3 ---  003 3 ---  013 3 --- }
0139:      { 000 3 ---  010 3 ---  001 3 ---  011 3 --- }
013A:      { 002 3 ---  012 3 ---  003 3 ---  013 3 --- }
