0100: 0100 { 182 2 ---  192 2 ---  183 2 ---  193 2 --- }
0101: 0101 { 181 2 ---  1D0 2 ---  183 2 ---  193 2 --- }
0102: 0102 { 18D 2 ---  1D0 2 ---  183 2 ---  193 2 --- }
0103: 0103 { 182 2 ---  192 2 ---  181 2 x--  1D0 2 x-- }
0104: 0104 { 182 2 ---  192 2 ---  18D 2 x--  1D0 2 x-- }
0105: 0105 { 00D 6 ---  0F8 2 ---  00D 6 ---  0F8 2 --- }
0106: 0106 { 02C 7 ---  03C 7 ---  02C 7 x--  03C 7 x-- }
0107: 0107
0108: 0108
0109: 0109
010A: 010A
010B: 010B
010C: 010C
010D: 010D
010E: 010E
010F: 010F
0110: 0110
0111: 0111 { 064 4 ---  066 4 ---  065 4 ---  067 4 --- }
0112: 0112 { 0DA 7 ---  0DC 7 ---  0DB 7 ---  0DD 7 --- }
0113: 0113 { 064 4 ---  066 4 ---  065 4 ---  067 4 --- }
0114: 0114 { 060 6 ---  062 6 ---  061 6 ---  063 6 --- }
0115: 0115 { 064 4 ---  066 4 ---  065 4 ---  067 4 --- }
0116: 0116 { 064 4 ---  066 4 ---  065 4 ---  067 4 --- }
0117: 0117 { 068 6 ---  06A 6 ---  069 6 ---  06B 6 --- }
0118: 0118 { 068 6 ---  06A 6 ---  069 6 ---  06B 6 --- }
0119: 0119 { 068 6 ---  06A 6 ---  069 6 ---  06B 6 --- }
011A: 011A { 068 6 ---  06A 6 ---  069 6 ---  06B 6 --- }
011B: 011B { 068 6 ---  06A 6 ---  069 6 ---  06B 6 --- }
011C: 011C { 068 6 ---  06A 6 ---  069 6 ---  06B 6 --- }
011D: 011D { 068 6 ---  06A 6 ---  069 6 ---  06B 6 --- }
011E: 011E { 006 6 ---  016 6 ---  007 6 ---  017 6 --- }
011F: 011F { 060 6 ---  062 6 ---  061 6 ---  063 6 --- }
0120: 0120 { 060 6 ---  062 6 ---  061 6 ---  063 6 --- }
0121: 0121 { 060 6 ---  062 6 ---  061 6 ---  063 6 --- }
0122: 0122 { 060 6 ---  062 6 ---  061 6 ---  063 6 --- }
0123: 0123 { 060 6 ---  062 6 ---  061 6 ---  063 6 --- }
0124: 0124 { 060 6 ---  062 6 ---  061 6 ---  063 6 --- }
0125: 0125 { 060 6 ---  062 6 ---  061 6 ---  063 6 --- }
0126: 0126 { 060 6 ---  062 6 ---  061 6 ---  063 6 --- }
0127: 0127 { 060 6 ---  062 6 ---  061 6 ---  063 6 --- }
0128: 0128 { 060 6 ---  062 6 ---  061 6 ---  063 6 --- }
0129: 0129 { 006 6 ---  016 6 ---  007 6 ---  017 6 --- }
012A: 012A { 006 6 ---  016 6 ---  007 6 ---  017 6 --- }
012B: 012B { 006 6 ---  016 6 ---  007 6 ---  017 6 --- }
012C: 012C { 08E 4 ---  09E 4 ---  08F 4 ---  09F 4 --- }
012D: 012D { 0BE 5 ---  0F6 5 ---  0D7 5 ---  0F7 5 --- }
012E: 012E { 068 7 ---  06A 7 ---  069 7 ---  06B 7 --- }
012F: 012F { 05C 6 ---  05E 6 ---  05D 6 ---  05F 6 --- }
0130: 0130 { 030 4 ---  032 4 ---  031 4 ---  033 4 --- }
0131: 0131 { 000 0 ---  000 0 ---  000 0 ---  000 0 --- }
0132: 0132 { 058 6 ---  05A 6 ---  059 6 ---  05B 6 --- }
0133: 0133 { 000 5 ---  010 5 ---  001 5 ---  011 5 --- }
0134: 0134 { 002 5 ---  012 5 ---  003 5 ---  013 5 --- }
0135: 0135 { 020 5 ---  020 5 ---  021 5 ---  021 5 --- }
0136: 0136 { 022 5 ---  022 5 ---  023 5 ---  023 5 --- }
0137: 0137 { 000 5 ---  010 5 ---  001 5 ---  011 5 --- }
0138: 0138 { 002 5 ---  012 5 ---  003 5 ---  013 5 --- }
0139: 0139 { 000 5 ---  010 5 ---  001 5 ---  011 5 --- }
013A: 013A { 002 5 ---  012 5 ---  003 5 ---  013 5 --- }
013B: 013B { 004 5 ---  014 5 ---  005 5 ---  015 5 --- }
013C: 013C { 024 5 ---  034 5 ---  025 5 ---  035 5 --- }
013D: 013D { 02E 5 ---  03E 5 ---  02E 5 ---  03E 5 --- }
013E: 013E { 02F 5 ---  03F 5 ---  02F 5 ---  03F 5 --- }
013F: 013F { 024 5 ---  034 5 ---  025 5 ---  035 5 --- }
0140: 0140 { 006 6 ---  016 6 ---  007 6 ---  017 6 --- }
0141: 0141 { 00A 4 ---  01A 4 ---  00A 4 x--  01A 4 x-- }
0142: 0142 { 02A 4 ---  03A 4 ---  02B 4 ---  03B 4 --- }
0143: 0143 { 083 4 ---  083 4 ---  084 4 ---  084 4 --- }
0144: 0144 { 01C 6 -y-  01C 6 ---  01C 6 xy-  01C 6 x-- }
0145: 0145 { 180 2 ---  190 2 ---  183 2 ---  193 2 --- }
0146: 0146 { 191 2 ---  190 2 ---  183 2 ---  193 2 --- }
0147: 0147 { 1D7 2 ---  190 2 ---  183 2 ---  193 2 --- }
0148: 0148 { 182 2 ---  192 2 ---  180 2 x--  190 2 x-- }
0149: 0149 { 182 2 ---  192 2 ---  191 2 x--  190 2 x-- }
014A: 014A { 182 2 ---  192 2 ---  1D7 2 x--  190 2 x-- }
014B: 014B { 184 2 ---  190 2 ---  195 2 ---  193 2 --- }
014C: 014C { 194 2 ---  192 2 ---  184 2 x--  190 2 x-- }
014D: 014D { 190 2 -y-  180 2 -y-  193 2 -y-  183 2 -y- }
014E: 014E { 192 2 -y-  182 2 -y-  193 2 -y-  183 2 -y- }
014F: 014F { 192 2 -y-  182 2 -y-  190 2 xy-  180 2 xy- }
0150: 0150 { 190 2 -y-  184 2 -y-  193 2 -y-  195 2 -y- }
0151: 0151 { 192 2 -y-  194 2 -y-  190 2 xy-  184 2 xy- }
0152: 0152 { 0F8 4 ---  0F8 4 ---  0F8 4 ---  0F8 4 --- }
0153: 0153
0154: 0154
0155: 0155
0156: 0156
0157: 0157
0158: 0158
0159: 0159
015A: 015A
015B: 015B
015C: 015C
015D: 015D
015E: 015E
015F: 015F
0160: 0160
0161: 0161
0162: 0162
0163: 0163
0164: 0164
0165: 0165
0166: 0166
0167: 0167
0168: 0168
0169: 0169
016A: 016A
016B: 016B
016C: 016C
016D: 016D
016E: 016E { 0F8 2 ---  1B4 2 ---  0F8 2 ---  1B5 2 --- }
016F: 016F { 194 2 ---  1A9 2 ---  195 2 ---  1AA 2 --- }
0170: 0170 { 1C0 2 ---  1BE 2 ---  195 2 ---  1AA 2 --- }
0171: 0171 { 1C5 2 ---  1CC 2 ---  1C5 2 ---  1CD 2 --- }
0172: 0172 { 0FB 2 ---  1CC 2 ---  0FB 2 ---  1CD 2 --- }
0173: 0173 { 0F8 2 ---  1B6 2 ---  0F8 2 ---  1B7 2 --- }
0174: 0174 { 194 2 ---  1AB 2 ---  195 2 ---  1AC 2 --- }
0175: 0175 { 1C0 2 ---  1AF 2 ---  195 2 ---  1AC 2 --- }
0176: 0176 { 1C5 2 ---  1CE 2 ---  1C5 2 ---  1CF 2 --- }
0177: 0177 { 0FB 2 ---  1CE 2 ---  0FB 2 ---  1CF 2 --- }
0178: 0178 { 1B4 2 ---  1B8 2 ---  1B5 2 ---  1B9 2 --- }
0179: 0179 { 1ED 2 ---  1B8 2 ---  1EE 2 ---  1B9 2 --- }
017A: 017A { 1EF 2 ---  1B8 2 ---  1EE 2 ---  1B9 2 --- }
017B: 017B { 1C6 2 ---  1B8 2 ---  1C7 2 ---  1B9 2 --- }
017C: 017C { 1CC 2 ---  1B8 2 ---  1CD 2 ---  1B9 2 --- }
017D: 017D { 1A4 2 ---  1BA 2 ---  1A5 2 ---  193 2 --- }
017E: 017E { 1BB 2 ---  1BA 2 ---  1BC 2 ---  193 2 --- }
017F: 017F { 1BF 2 ---  1BA 2 ---  1BC 2 ---  193 2 --- }
0180: 0180 { 1C8 2 ---  1BA 2 ---  1A5 2 ---  193 2 --- }
0181: 0181 { 1CA 2 ---  1BA 2 ---  1A5 2 ---  193 2 --- }
0182: 0182 { 1A5 2 x--  192 2 ---  1A4 2 x--  1BA 2 x-- }
0183: 0183 { 1BC 2 x--  192 2 ---  1BB 2 x--  1BA 2 x-- }
0184: 0184 { 1BC 2 x--  193 2 x--  1BF 2 x--  1BA 2 x-- }
0185: 0185 { 1A5 2 x--  192 2 ---  1C8 2 x--  1BA 2 x-- }
0186: 0186 { 1A5 2 x--  192 2 ---  1CA 2 x--  1BA 2 x-- }
0187: 0187 { 1B5 2 x--  1B9 2 x--  1B4 2 x--  1B8 2 x-- }
0188: 0188 { 1EE 2 x--  1B9 2 x--  1ED 2 x--  1B8 2 x-- }
0189: 0189 { 1EE 2 x--  1B9 2 x--  1EF 2 x--  1B8 2 x-- }
018A: 018A { 1C7 2 x--  1B9 2 x--  1C6 2 x--  1B8 2 x-- }
018B: 018B { 1CD 2 x--  1B9 2 x--  1CC 2 x--  1B8 2 x-- }
018C: 018C { 0F8 2 ---  1B7 2 x--  0F8 2 ---  1B6 2 x-- }
018D: 018D { 194 2 ---  1AC 2 x--  195 2 ---  1AB 2 x-- }
018E: 018E { 194 2 ---  1AC 2 x--  1C0 2 x--  1AF 2 x-- }
018F: 018F { 1C5 2 ---  1CF 2 x--  1C5 2 ---  1CE 2 x-- }
0190: 0190 { 0FB 2 ---  1CF 2 x--  0FB 2 ---  1CE 2 x-- }
0191: 0191 { 0F8 2 ---  1B5 2 x--  0F8 2 ---  1B4 2 x-- }
0192: 0192 { 194 2 ---  1AA 2 x--  195 2 ---  1A9 2 x-- }
0193: 0193 { 194 2 ---  1AA 2 x--  1C0 2 x--  1BE 2 x-- }
0194: 0194 { 1C5 2 ---  1CD 2 x--  1C5 2 ---  1CC 2 x-- }
0195: 0195 { 0FB 2 ---  1CD 2 x--  0FB 2 ---  1CC 2 x-- }
0196: 0196 { 0F8 2 ---  19B 2 ---  0F8 2 ---  19C 2 --- }
0197: 0197 { 194 2 ---  1A0 2 ---  195 2 ---  1B1 2 --- }
0198: 0198 { 1C0 2 ---  18F 2 ---  195 2 ---  1B1 2 --- }
0199: 0199 { 1C5 2 ---  1D5 2 ---  1C5 2 ---  1D6 2 --- }
019A: 019A { 0FB 2 ---  1D5 2 ---  0FB 2 ---  1D6 2 --- }
019B: 019B { 19B 2 ---  19D 2 ---  18E 2 ---  19E 2 --- }
019C: 019C { 1EC 2 ---  19D 2 ---  1A1 2 ---  19E 2 --- }
019D: 019D { 1EB 2 ---  19D 2 ---  1A1 2 ---  19E 2 --- }
019E: 019E { 1CA 2 ---  19D 2 ---  1CB 2 ---  19E 2 --- }
019F: 019F { 1D5 2 ---  19D 2 ---  1D6 2 ---  19E 2 --- }
01A0: 01A0 { 18E 2 x--  19E 2 x--  19B 2 x--  19D 2 x-- }
01A1: 01A1 { 1A1 2 x--  19E 2 x--  1EC 2 x--  19D 2 x-- }
01A2: 01A2 { 1A1 2 x--  19E 2 x--  1EB 2 x--  19D 2 x-- }
01A3: 01A3 { 1CB 2 x--  19E 2 x--  1CA 2 x--  19D 2 x-- }
01A4: 01A4 { 1D6 2 x--  19E 2 x--  1D5 2 x--  19D 2 x-- }
01A5: 01A5 { 0F8 2 ---  19C 2 x--  0F8 2 ---  19B 2 x-- }
01A6: 01A6 { 194 2 ---  1B1 2 x--  195 2 ---  1A0 2 x-- }
01A7: 01A7 { 194 2 ---  1B1 2 x--  1C0 2 x--  18F 2 x-- }
01A8: 01A8 { 1C5 2 ---  1D6 2 x--  1C5 2 ---  1D5 2 x-- }
01A9: 01A9 { 0FB 2 ---  1D6 2 x--  0FB 2 ---  1D5 2 x-- }
01AA: 01AA { 0F8 2 ---  196 2 ---  187 2 ---  197 2 --- }
01AB: 01AB { 194 2 ---  188 2 ---  189 2 ---  197 2 --- }
01AC: 01AC { 1C0 2 ---  198 2 ---  189 2 ---  197 2 --- }
01AD: 01AD { 1C5 2 ---  1D8 2 ---  1C9 2 ---  197 2 --- }
01AE: 01AE { 0FB 2 ---  1D8 2 ---  1D8 2 ---  197 2 --- }
01AF: 01AF { 187 2 x--  197 2 x--  0F8 2 ---  196 2 x-- }
01B0: 01B0 { 189 2 x--  197 2 x--  195 2 ---  188 2 x-- }
01B1: 01B1 { 189 2 x--  197 2 x--  1C0 2 x--  198 2 x-- }
01B2: 01B2 { 1C9 2 x--  197 2 x--  1C5 2 ---  1D8 2 x-- }
01B3: 01B3 { 1D8 2 x--  197 2 x--  0FB 2 ---  1D8 2 x-- }
01B4: 01B4 { 0DE 7 ---  0EE 7 ---  0DF 7 ---  0EF 7 --- }
01B5: 01B5 { 0DF 7 x--  0EF 7 x--  0DE 7 x--  0EE 7 x-- }
01B6: 01B6 { 1C1 2 ---  1D1 2 ---  1C2 2 ---  1D2 2 --- }
01B7: 01B7 { 1C2 2 x--  1D2 2 x--  1C1 2 x--  1D1 2 x-- }
01B8: 01B8 { 1A4 2 ---  1BA 2 ---  1BD 2 ---  1D0 2 x-- }
01B9: 01B9 { 1BB 2 ---  1BA 2 ---  1AD 2 ---  1D0 2 x-- }
01BA: 01BA { 1BD 2 x--  1D0 2 ---  1A4 2 x--  1BA 2 x-- }
01BB: 01BB { 1AD 2 x--  1D0 2 ---  1BB 2 x--  1BA 2 x-- }
01BC: 01BC { 19B 2 ---  19D 2 ---  1A3 2 ---  1B2 2 --- }
01BD: 01BD { 1EC 2 ---  19D 2 ---  1A2 2 ---  1B2 2 --- }
01BE: 01BE { 1A3 2 x--  1B2 2 x--  19B 2 x--  19D 2 x-- }
01BF: 01BF { 1A2 2 x--  1B2 2 x--  1EC 2 x--  19D 2 x-- }
01C0: 01C0 { 0F8 2 ---  196 2 ---  18A 2 ---  19A 2 --- }
01C1: 01C1 { 194 2 ---  188 2 ---  199 2 ---  19A 2 --- }
01C2: 01C2 { 18A 2 x--  19A 2 x--  0F8 2 ---  196 2 x-- }
01C3: 01C3 { 199 2 x--  19A 2 x--  195 2 ---  188 2 x-- }
01C4: 01C4 { 196 2 -y-  0F8 2 ---  197 2 -y-  187 2 -y- }
01C5: 01C5 { 197 2 xy-  187 2 xy-  196 2 xy-  0F8 2 --- }
01C6: 01C6 { 19B 2 -y-  0F8 2 ---  19C 2 -y-  0F8 2 --- }
01C7: 01C7 { 19D 2 -y-  19B 2 -y-  19E 2 -y-  18E 2 -y- }
01C8: 01C8 { 19E 2 xy-  18E 2 xy-  19D 2 xy-  19B 2 xy- }
01C9: 01C9 { 19C 2 xy-  0F8 2 ---  19B 2 xy-  0F8 2 --- }
01CA: 01CA { 0F8 2 ---  0F8 2 ---  1C1 2 ---  1D1 2 --- }
01CB: 01CB { 1C1 2 ---  1D1 2 ---  1C2 2 ---  1D2 2 --- }
01CC: 01CC { 1C1 2 x--  1D1 2 x--  0F8 2 ---  0F8 2 --- }
01CD: 01CD { 1C2 2 x--  1D2 2 x--  1C1 2 x--  1D1 2 x-- }
01CE: 01CE { 0F8 7 ---  044 2 ---  044 2 ---  045 2 --- }
01CF: 01CF { 048 2 x--  049 2 x--  0F8 7 ---  048 2 x-- }
01D0: 01D0 { 044 2 x--  045 2 x--  0F8 7 ---  044 2 x-- }
01D1: 01D1 { 0F8 7 ---  048 2 ---  048 2 ---  049 2 --- }
01D2: 01D2 { 0F8 3 --p  04C 3 --p  0F8 3 --p  04D 3 --p }
01D3: 01D3 { 04C 3 --p  04E 3 --p  04D 3 --p  04F 3 --p }
01D4: 01D4 { 041 3 x-p  043 3 x-p  040 3 x-p  042 3 x-p }
01D5: 01D5 { 0F8 3 --p  041 3 x-p  0F8 3 --p  040 3 x-p }
01D6: 01D6 { 0F8 3 --p  044 3 --p  044 3 --p  045 3 --p }
01D7: 01D7 { 046 3 x-p  047 3 x-p  0F8 3 --p  046 3 x-p }
01D8: 01D8 { 1A6 2 ---  192 2 ---  1A7 2 ---  193 2 --- }
01D9: 01D9 { 1AE 2 ---  1D0 2 ---  1A7 2 ---  193 2 --- }
01DA: 01DA { 1A8 2 ---  192 2 ---  195 2 ---  193 2 --- }
01DB: 01DB { 194 2 ---  192 2 ---  1A8 2 x--  193 2 --- }
01DC: 01DC { 1A7 2 x--  192 2 ---  1A6 2 x--  193 2 --- }
01DD: 01DD { 1A7 2 x--  192 2 ---  1AE 2 x--  1D0 2 x-- }
01DE: 01DE { 18C 2 ---  192 2 ---  1B3 2 ---  193 2 --- }
01DF: 01DF { 19F 2 ---  1D0 2 ---  1B3 2 ---  193 2 --- }
01E0: 01E0 { 1B3 2 x--  192 2 ---  18C 2 x--  193 2 --- }
01E1: 01E1 { 1B3 2 x--  192 2 ---  19F 2 x--  1D0 2 x-- }
01E2: 01E2 { 186 2 ---  192 2 ---  195 2 ---  193 2 --- }
01E3: 01E3 { 18B 2 ---  1D0 2 ---  195 2 ---  193 2 --- }
01E4: 01E4 { 194 2 ---  192 2 ---  186 2 x--  193 2 --- }
01E5: 01E5 { 194 2 ---  192 2 ---  18B 2 x--  1D0 2 x-- }
01E6: 01E6 { 194 2 ---  192 2 ---  195 2 ---  193 2 --- }
01E7: 01E7 { 1C0 2 ---  1D0 2 ---  195 2 ---  193 2 --- }
01E8: 01E8 { 194 2 ---  192 2 ---  1C0 2 x--  1D0 2 x-- }
01E9: 01E9 { 186 2 ---  192 2 ---  1C0 2 x--  1D0 2 x-- }
01EA: 01EA { 1C0 2 ---  1D0 2 ---  186 2 x--  193 2 x-- }
01EB: 01EB { 182 2 ---  192 2 ---  183 2 ---  193 2 --- }
01EC: 01EC { 192 2 -y-  186 2 -y-  193 2 -y-  195 2 -y- }
01ED: 01ED { 192 2 -y-  194 2 -y-  193 2 -y-  186 2 xy- }
01EE: 01EE { 192 2 -y-  18C 2 -y-  193 2 -y-  1B3 2 -y- }
01EF: 01EF { 192 2 -y-  1B3 2 xy-  193 2 -y-  18C 2 xy- }
01F0: 01F0 { 192 2 -y-  194 2 -y-  193 2 -y-  195 2 -y- }
01F1: 01F1 { 1C2 2 ---  1D2 2 ---  195 2 ---  193 2 --- }
01F2: 01F2 { 194 2 ---  192 2 ---  1C2 2 x--  1D2 2 x-- }
01F3: 01F3 { 045 2 ---  047 2 ---  047 2 ---  192 2 --- }
01F4: 01F4 { 04B 2 x--  192 2 x--  049 2 x--  04B 2 x-- }
01F5: 01F5 { 047 2 x--  192 2 x--  045 2 x--  047 2 x-- }
01F6: 01F6 { 049 2 ---  04B 2 ---  04B 2 ---  192 2 --- }
01F7: 01F7 { 1C2 2 ---  0F8 2 ---  193 2 ---  1D1 2 xy- }
01F8: 01F8 { 1F3 2 ---  193 2 ---  193 2 ---  1B0 2 xy- }
01F9: 01F9 { 194 2 ---  1D1 2 -y-  1C2 2 x--  0F8 2 --- }
01FA: 01FA { 194 2 ---  1B0 2 -y-  1F3 2 x--  193 2 --- }
01FB: 01FB { 04E 3 --p  0FB 3 --p  04F 3 --p  0FB 3 --p }
01FC: 01FC { 043 3 x-p  0FB 3 --p  042 3 x-p  0FB 3 --p }
01FD: 01FD { 045 3 --p  0FB 3 --p  0FB 3 --p  0FB 3 --p }
01FE: 01FE { 0FB 3 --p  0FB 3 --p  047 3 x-p  0FB 3 --p }
01FF: 01FF { 0FB 3 --p  0FB 3 --p  0FB 3 --p  0FB 3 --p }
